4月の歌 Flowers アンダーライン 英語→日本語
gold	貴重な宝物
dream	夢
can’t be sold	売り渡せない
watched it burn	目の前で焼け落ちてしまった
didn’t wanna leave	離れたくなかった
lie	嘘
remembered	思い出した
Talk to myself	自分に語りかけて
don’t understand	理解できない
hold my own hand	自分で自分の手を握る
better than you	あなたよりも
love me	愛せる
Paint	塗ろう
left	残していった
Match	ぴったり合う
No remorse	悔いはない
no regret	未練もない
forget	許す
fighy	ケンカ
